R 1024 576

NO textures/north_tex128.xpm
EA textures/east_tex128.xpm
SO textures/south_tex128.xpm
WE textures/west_tex128.xpm

S sprites/can.xpm

F 10, 8,  1
C  0, 6, 27

1111111111111111
1000000000000001
1011100100010101
1000210010000001
1001100010010101
1012000010000001
1001110010010101
1000000000000001
1010101001010101
1000000000000001
1111111001111111
1021S00000000001
1011000110110111
1010000000100221
1000111012100221
1111111111111111
